                  #         #                                |
                  #         #                                |
                  #         #                                |
                  # C       #                                |
                  ###       #                                |
                  ##### #####                                |
                     #   #               ##############      |
        E            #   #               ##############      |
                     #   #               ##############      |
                     #   #               ##############      |
                     #   ###########     ##############      |
                     #   ###########     ##############      |
                     #   ###########     ##############      |
                     #   ###########     ##############      |
                     #   ###########     ##############      |
                     #   ###########     ##############      |
    E                #   ###########     ##############      |
                     #   ###########                         |
                     #   ###########                         |
                     #   ###########                         |
                       P                                     |
                                                             |
                                            ######## ########|
                                            #                |
                                            #                |
                                            #                |
                                            ###              |
                                            ###              |
                       ########             #                |
                       ###########          #                |
                       ###########          #                |
                     #############          #                |
                     #############          #                |
