                 #        #                                  |
                 #        #                                  |
                 #        #                                  |
                 # C      #                                  |
                 ###      #                                  |
                 ##### ####                                  |
                    #   #               ##############       |
                    #   #               ##############       |
                    #   #               ##############       |
                    #   #               ##############       |
                    #   ###########     ##############       |
                    #   ###########     ##############       |
                    #   ###########     ##############       |
                    #   ###########     ##############       |
                    #   ###########     ##############       |
                    #   ###########     ##############       |
                    #   ###########     ##############       |
                    #   ###########                          |
                    #   ###########                          |
                                                             |
                      P                                      |
                                                             |
                                            ######## ########|
                                            #                |
                                            #                |
                                            #                |
                                            ###              |
                                            ###              |
                       ########             #                |
                       ###########          #                |
                       ###########          #                |
                     #############          #                |
                     #############          #                |
